11111111111111111111111111111111111
1C0000000000000000000000000000000C1
1000000C000001110000001111111100001
100C0000000111C00000111P00011100001
10000000011101110000000001110000001
1000000111001110000000111C000000001
10CC0111111111110001110C000000C0001
1000C0000E1110000111C00000000000001
10000000011100011111111111000000001
11111111111111111111111111111111111
