1111111111111111111111111111111
1C000000000000000000000000000C1
10000C0000011100000011111111001
10C000000111C00000111P000111001
1000000111011100000000011100001
10000111001110000000111C0000001
1C0111111111110001110C00000C001
10C0000E1110000111C000000000001
1000000111000111111111110000001
1C000000000000000000000000000C1
1111111111111111111111111111111
