1111111111
1C100001C1
1000000001
1000110001
1000EP0001
1000110001
1000000001
1C100001C1
1111111111
