111111111111111111111111111111111
1P1C100000000C0000100000000C100C1
101010111111101011101111101110111
10100010101000100C1C1C00000000001
101111101011111011111110101111101
101000000000100000000000100010001
101110101111101110111111111011101
100000101000001000001000001010001
101011111011101010101111101111111
1010000C00001010101010C0001C00001
101110101011111011111110101111101
1000101C1010101000001010100000101
101011111010101111111010111011101
1010101C1010100C00100000100010001
101010101010101010101110111011101
1010000C10000010100010001C00000E1
111111111111111111111111111111111
